ab|1|0
123456123455|6|0
123456789987654321|9|0
1234abcd|4|0
123456789123456789|9|1
123456789|9|1
12341234|4|1
123456781234|4|1
ab ba|1|1
abcdedcba|1|1
abcddcba|1|1
121212|2|1
123456789789456123|3|1
123456789456123|3|1
123456|6|1
123456123456|6|1
abcdef123456abcdef|6|1
